%%%%%%%
%    P%
%  %  %
% %   %
%   % %
%. %% %
%%%%%%%
